0000000000000000000000000000
0202520000022201100001201350
0000200002200021022005001150
0202000200000101000001000000
0000001155511221002000020010
0001000000000000002011122020
0000500011050000500015100000
0220020000000000510200000020
0200001115102022010000000000
0000000020000100000002100100
0000005111010020010010005100
0002002000202000210201000520
0200200020000000010000000120
0200000000000010010000001000
0020022200550402050002010000
0000000000000000000000000000