2222222222222222222222222222
2111111222211111122111121112
2121112221111111111111111112
2111221111111111122111111112
2212111111111111121112111112
2211111111112222121111111212
2212122211212222122211122212
2112111111212222111111111212
2122121111111211111222221212
2121121111211121111211121112
2121121111211112212211121112
2121211111121111111111111112
2122111111112221111211111112
2122222222111111111211111222
2111111111112121111111112222
2222222222222222222222222222