0000000000000000000000000000
0000000000000300000000000000
0002551200000005002000200000
0020000020001010150100020000
0000021000102002000010002000
0050500002010050050102000200
0050501550105000005020200000
0050005510102020200200020000
0050205000050000100000000100
0000000000002022022200000200
0002002020000000000002000000
0000150001500110015000510000
0020000020000200000200000200
0000020000200000200000200000
0000000000000040000000000000
0000000000000000000000000000