2222222222222222222222222222
2212221111211111112111111112
2111111221211111121111111112
2212122211211111212211111112
2211111121111111111112222112
2111111121111111211122111112
2122222111111111111122222212
2121111121222111112121111112
2121111111111211112121111212
2111111121111112111121111212
2122111121222112111211111212
2122212121121112112121111112
2111112121111212111112111122
2122212122122111111111111222
2111111111111111222111112222
2222222222222222222222222222