0000000000000000000000000000
0020005222020155000212122550
0400000002000125002250000550
0050500001002110020000200050
0010000000200550000000000000
0200022200020111011100222250
0200000112102135002000000000
0000000000000111120000000100
0000020510100015510000110020
0500111000000000000000210020
0500000001000100500020010000
0500000000000120500200010500
0521220000000000500200011500
0500000100000001001001055000
0221000055200002000502050000
0000000000000000000000000000