2222222222222222222222222222
2222222222222112222222222222
2221111111111111111111111222
2211222112111212112112111122
2212111121121211111111211122
2212112211211212212121121122
2212121112111211211112112122
2212121112111211121111212122
2212121222212222122221212122
2211111211111211111121111122
2211111211112111111121111122
2222112221122112211222112222
2211111111111111111111111122
2221111111111111111111111222
2222222222222112222222222222
2222222222222222222222222222